#####
#@$.#
#####
;
 ########
##      #
#       #
#   .   #
#   $   #
# .$@$. #
####$   #
   #.   #
   #   ##
   #####
;
####     ######
# .#     #.   #
#  #     #    #
#  ######## $ #
#   #         #
#   #         #
#   #$    .#$ #
#      @###   #
#             #
###############
;
################
#. #.#    #   @#
#    #$  $#    #
#              #
##   ######    #
# $#           #
#             .#
################
;
#########
#@  #  .#
#  $#   #
#       #
##     ##
  #####




